111111111111111
111111111111122
111111111111121
222221111111121
111121111122221
111122211221111
111111211211111
111111222211111
