222211111111111
111211111111111
122211111111111
121111111222111
121111111212111
122111222212111
112111211112111
112222211112222
