122221122212222
121321123212311
121121321212221
121121321211121
321121121211121
321121123211121
221123121213123
111322221222221
